
#################
# ------------#--#
# --#######---#--########
# --#-----#---#---------#
# --#--S--#-E-#--#--##--###
# --#-----#---#--#--#E--#E#
######-#######--#--##--###
# ----------------------#
########################
#####